{
  "width": 15,
  "height": 12,
  "goal": {
    "x": 13,
    "y": 2
  },
  "tiles": [
    [4, 4, 4, 4, 4, 4, 4, 4, 4, 4, 4, 4, 4, 4, 4],
    [4, 0, 0, 0, 0, 0, 0, 0, 0, 0, 0, 0, 0, 5, 4],
    [4, 0, 0, 2, 0, 0, 1, 1, 0, 0, 3, 0, 0, 0, 4],
    [4, 0, 0, 0, 0, 0, 1, 1, 0, 0, 0, 0, 2, 0, 4],
    [4, 0, 2, 0, 0, 0, 0, 0, 0, 0, 0, 0, 0, 0, 4],
    [4, 0, 0, 0, 0, 0, 0, 0, 0, 3, 0, 0, 0, 0, 4],
    [4, 0, 0, 3, 0, 0, 0, 2, 0, 0, 0, 0, 0, 0, 4],
    [4, 0, 0, 0, 0, 0, 0, 0, 0, 0, 0, 2, 0, 0, 4],
    [4, 0, 1, 1, 0, 0, 0, 0, 0, 0, 0, 0, 0, 0, 4],
    [4, 0, 1, 1, 0, 0, 3, 0, 0, 0, 0, 0, 0, 0, 4],
    [4, 0, 0, 0, 0, 0, 0, 0, 0, 0, 0, 0, 0, 0, 4],
    [4, 4, 4, 4, 4, 4, 4, 4, 4, 4, 4, 4, 4, 4, 4]
  ]
}
